Account No.,DATE,Transaction Details,CHQ.NO.,Value Date,Withdrawal Amount,Deposit Amount,Balance Amount,.
23468455355,42915,TRF FROM  Indiaforensic SERVICES,,42915,,1000000,1000000,.
23468455356,42921,TRF FROM  Indiaforensic SERVICES,,42921,,1000000,2000000,.
23468455357,42934,FDRL/INTERNAL FUND TRANSFE,,42934,,500000,2500000,.
23468455358,42948,TRF FRM  Indiaforensic SERVICES,,42948,,3000000,5500000,.
23468455359,42963,FDRL/INTERNAL FUND TRANSFE,,42963,,500000,6000000,.
23468455360,42963,FDRL/INTERNAL FUND TRANSFE,,42963,,500000,6500000,.
23468455361,42963,FDRL/INTERNAL FUND TRANSFE,,42963,,500000,7000000,.
23468455362,42963,FDRL/INTERNAL FUND TRANSFE,,42963,,500000,7500000,.
23468455363,42963,FDRL/INTERNAL FUND TRANSFE,,42963,,500000,8000000,.
23468455364,42963,FDRL/INTERNAL FUND TRANSFE,,42963,,500000,8500000,.
23462522414,42963,INDO GIBL Indiaforensic STL01071,,42963,133900,,8366100,.
23462522414,42963,INDO GIBL Indiaforensic STL02071,,42963,18000,,8348100,.
23462522414,42963,INDO GIBL Indiaforensic STL03071,,42963,5000,,8343100,.
23462522414,42963,INDO GIBL Indiaforensic STL04071,,42963,195800,,8147300,.
23462522415,42963,INDO GIBL Indiaforensic STL05071,,42963,81600,,8065700,.
23462522416,42963,INDO GIBL Indiaforensic STL06071,,42963,41800,,8023900,.
23462522417,42963,INDO GIBL Indiaforensic STL07071,,42963,98500,,7925400,.
23462522418,42963,INDO GIBL Indiaforensic STL10071,,42963,143800,,7781600,.
23462522419,42963,INDO GIBL Indiaforensic STL11071,,42963,331650,,7449950,.
23462522420,42282,CASHPMT/GURGAON/SELF,873917,42282,100000,,7349950,.
23462522421,42282,INTERNAL FUND TRANSFER IN,,42282,15000000,,-7650050,.
23462522422,42282,INTERNAL FUND TRANSFER IN,,42282,15000000,,-22650050,.
23462522423,42282,INTERNAL FUND TRANSFER IN,,42282,15000000,,-37650050,.
23462522424,42282,RTGS/SBINH15278726552/Indfor,,42282,,14900000,-22750050,.
23462522425,42282,RTGS/SBINH15278726620/Indfor,,42282,,14900000,-7850050,.
23462522426,42282,TRANGLO SDN BHD/USD/40000,,42282,,2604000,-5246050,.
23462522427,42282,IRTT00701513532,,42282,1279.56,,-5247329.56,.
23462522428,42282,"Indiaforensic USA, INC./USD/1037",,42282,,6756066.28,1508736.72,.
23462522429,42282,IRTT00701513533,,42282,1860.85,,1506875.87,.
23462522430,42282,Indiaforensic SERVICES INDIA PVT,,42282,,18942514,20449389.87,.
23462522431,42282,INTERNAL FUND TRANSFER IN,,42282,15000000,,5449389.87,.
23462522432,42282,INTERNAL FUND TRANSFER IN,,42282,15000000,,-9550610.13,.
23462522433,42282,INTERNAL FUND TRANSFER IN,,42282,15000000,,-24550610.13,.
23462522434,42282,NEFT/SBIN515278779021/Indfor,,42282,,14900000,-9650610.13,.
23462522435,42282,NEFT/SBIN515278779211/Indfor,,42282,,11000000,1349389.87,.
23462522436,42282,NEFT/AXISF15278050946/Indfor,,42282,,4250000,5599389.87,.
23468455391,42282,NEFT/AXISF15278050810/Indfor,,42282,,2000000,7599389.87,.
23468455392,42283,INTERNAL FUND TRANSFER IN,,42283,10000000,,-2400610.13,.
23468455393,42283,INTERNAL FUND TRANSFER IN,,42283,10000000,,-12400610.13,.
23468455394,42283,INTERNAL FUND TRANSFER IN,,42283,10000000,,-22400610.13,.
23468455395,42283,IWSTHCTS1/S PRASANTHO KUM,873645,42283,15000,,-22415610.13,.
23468455396,42283,IWSTHCTS1/SAVARA TATARAO,873654,42283,15000,,-22430610.13,.
23468455397,42283,RTGS/PUNBH15279008026/Indfor,,42283,,2400000,-20030610.13,.
23468455398,42283,MAHESH CHANDRA JAIN,873662,42283,3886,,-20034496.13,.
23468455399,42283,INTERNAL FUND TRANSFER IN,,42283,10000000,,-30034496.13,.
23468455400,42283,INTERNAL FUND TRANSFER IN,,42283,10000000,,-40034496.13,.
23468455401,42283,INTERNAL FUND TRANSFER IN,,42283,10000000,,-50034496.13,.
23468455402,42283,INTERNAL FUND TRANSFER IN,,42283,10000000,,-60034496.13,.
23468455403,42283,RTGS/CIUBH15279642588/Indfor,,42283,,1000000,-59034496.13,.
23468455404,42283,RTGS/KVBLH15279299855/Indfor,,42283,,1200000,-57834496.13,.
23468455405,42283,RTGS/SBTRH15279185865/Indfor,,42283,,1450000,-56384496.13,.
23468455406,42283,Indiaforensic SERVICES INDIA PVT,,42283,,5283525,-51100971.13,.
23468455407,42283,INTERNAL FUND TRANSFER IN,,42283,10000000,,-61100971.13,.
23468455408,42283,NEFT/SBIN615279745176/Indfor,,42283,,14900000,-46200971.13,.
23468455409,42283,NEFT/SBIN615279745932/Indfor,,42283,,14900000,-31300971.13,.
23468455410,42283,NEFT/AXISF15279090660/Indfor,,42283,,6200000,-25100971.13,.
23468455411,42283,NEFT/SBIN615279744409/Indfor,,42283,,14900000,-10200971.13,.
23468455412,42283,NEFT/AXISF15279090806/Indfor,,42283,,10000000,-200971.13,.
23468455413,42283,NEFT/AXISF15279090687/Indfor,,42283,,5100000,4899028.87,.
23468455414,42283,INTERNAL FUND TRANSFER IN,,42283,15000000,,-10100971.13,.
23468455415,42283,INTERNAL FUND TRANSFER IN,,42283,15000000,,-25100971.13,.
23468455416,42283,INTERNAL FUND TRANSFER IN,,42283,15000000,,-40100971.13,.
23468455417,42283,INTERNAL FUND TRANSFER IN,,42283,10000000,,-50100971.13,.
23468455418,42283,FIXED  MOBILE PTE LTD/USD,,42283,,3905664.12,-46195307.01,.
23468455419,42283,IRTT00701513652,,42283,1461.79,,-46196768.8,.
23468455420,42284,RTGS/YESBH15280015242/Indfor,,42284,10000000,,-56196768.8,.
23468487134,42284,INTERNAL FUND TRANSFER IN,,42284,10000000,,-66196768.8,.
23468487134,42284,INTERNAL FUND TRANSFER IN,,42284,10000000,,-76196768.8,.
23468487134,42284,RTGS/ICICH15280016715/Indfor,,42284,,15000000,-61196768.8,.
23468487134,42284,RTGS/ICICH15280016720/Indfor,,42284,,15000000,-46196768.8,.
23468487135,42284,INTERNAL FUND TRANSFER IN,,42284,15000000,,-61196768.8,.
23468487136,42284,INTERNAL FUND TRANSFER IN,,42284,10000000,,-71196768.8,.
23468487137,42284,TATA TELESERVICES LTD AC,873907,42284,1142,,-71197910.8,.
23468487138,42284,INDER PRAKASH SARID,873918,42284,592982,,-71790892.8,.
23468487139,42284,TRANGLO SDN BHD/USD/70000,,42284,,4555600,-67235292.8,.
23468487140,42284,IRTT00701513709,,42284,1552.78,,-67236845.58,.
23468487141,42284,RTGS/SBINH15280809398/Indfor,,42284,,12000000,-55236845.58,.
23468487142,42284,RTGS/ICICH15280047445/Indfor,,42284,,8000000,-47236845.58,.
23468487143,42284,INTERNAL FUND TRANSFER IN,,42284,8000000,,-55236845.58,.
23468487144,42284,INTERNAL FUND TRANSFER IN,,42284,10000000,,-65236845.58,.
23468487145,42284,RTGS/ICICH15280065315/Indfor,,42284,,10000000,-55236845.58,.
23468487146,42284,RTGS/ICICH15280065323/Indfor,,42284,,10000000,-45236845.58,.
23468487147,42284,RTGS/SBINH15280826115/Indfor,,42284,,14900000,-30336845.58,.
23468487148,42284,RTGS/SBINH15280826154/Indfor,,42284,,10000000,-20336845.58,.
23468487149,42284,Indiaforensic SERVICES INDIA PVT,,42284,,4887589,-15449256.58,.
23468487150,42284,INTERNAL FUND TRANSFER IN,,42284,15000000,,-30449256.58,.
23468487151,42284,INTERNAL FUND TRANSFER IN,,42284,15000000,,-45449256.58,.
23468487152,42284,INTERNAL FUND TRANSFER IN,,42284,15000000,,-60449256.58,.
23468487153,42284,INTERNAL FUND TRANSFER IN,,42284,15000000,,-75449256.58,.
23468487154,42284,INTERNAL FUND TRANSFER IN,,42284,15000000,,-90449256.58,.
23468487155,42284,NEFT/AXISF15280029353/Indfor,,42284,,1900000,-88549256.58,.
23468487156,42284,NEFT/SBIN715280720258/Indfor,,42284,,14900000,-73649256.58,.
23468487157,42284,NEFT/AXISF15280029383/Indfor,,42284,,1200000,-72449256.58,.
23468487158,42284,NEFT/FDRL342280535/Indiaforensic,,42284,,10000000,-62449256.58,.
23468487159,42284,NEFT/FDRL342280694/Indiaforensic,,42284,,5000000,-57449256.58,.
23468487160,42285,INTERNAL FUND TRANSFER IN,,42285,10000000,,-67449256.58,.
23468487161,42285,RTGS/ICICH15281089595/Indfor,,42285,,10000000,-57449256.58,.
23468487162,42285,INTERNAL FUND TRANSFER IN,,42285,15000000,,-72449256.58,.
23468487163,42285,INTERNAL FUND TRANSFER IN,,42285,500000,,-72949256.58,.
23468487164,42285,FIXED  MOBILE PTE LTD/USD,,42285,,6482276.3,-66466980.28,.
23468487165,42285,IRTT00701513760,,42285,1822.52,,-66468802.8,.
23468487166,42285,INTERNAL FUND TRANSFER IN,,42285,15000000,,-81468802.8,.
23468487167,42285,INTERNAL FUND TRANSFER IN,,42285,15000000,,-96468802.8,.
23468487168,42285,SONU GUPTA,873919,42285,20000,,-96488802.8,.
23468487169,42285,ETRAVEL VALUE  INDIA P LT,873915,42285,154620,,-96643422.8,.
23468487170,42285,IRTT00701513760:Remittanc,,42285,285,,-96643707.8,.
23468487171,42285,RTGS/SBINH15281865646/Indfor,,42285,,5000000,-91643707.8,.
23468487172,42285,Indiaforensic SERVICES INDIA PVT,,42285,,4745601,-86898106.8,.
23468487173,42285,RTGS/SBINH15281865637/Indfor,,42285,,14900000,-71998106.8,.
23468487174,42285,RTGS/SBINH15281865638/Indfor,,42285,,14900000,-57098106.8,.
23468487175,42285,INTERNAL FUND TRANSFER IN,,42285,12000000,,-69098106.8,.
23468487176,42285,INTERNAL FUND TRANSFER IN,,42285,12000000,,-81098106.8,.
23468487177,42285,INTERNAL FUND TRANSFER IN,,42285,15000000,,-96098106.8,.
23468487178,42285,RTGS/SBINH15281877826/Indfor,,42285,,14900000,-81198106.8,.
23468487179,42285,RTGS/SBINH15281877880/Indfor,,42285,,14900000,-66298106.8,.
23468487180,42285,NEFT/FDRL342280624/Indiaforensic,,42285,,15000000,-51298106.8,.
23468487181,42285,NEFT/FDRL342280645/Indiaforensic,,42285,,10000000,-41298106.8,.
23468487182,42285,INTERNAL FUND TRANSFER IN,,42285,15000000,,-56298106.8,.
23468487183,42285,INTERNAL FUND TRANSFER IN,,42285,15000000,,-71298106.8,.
23468455474,45582,INDO GIBL Indiaforensic STL19101,,45582,76389,,1214521,.
23468455475,45582,INDO GIBL Indiaforensic STL20101,,45582,62725,,1151796,.
23468455476,45582,INDO GIBL Indiaforensic STL21101,,45582,39000,,1112796,.
23468455477,45582,INDO GIBL Indiaforensic STL22101,,45582,9600,,1103196,.
23468455478,45582,INDO GIBL Indiaforensic STL23101,,45582,123260,,979936,.
23468455479,45582,INDO GIBL Indiaforensic STL24101,,45582,369803,,610133,.
23468455480,45582,INDO GIBL Indiaforensic STL25101,,45582,170125,,440008,.
23468455481,45582,FDRL/INTERNAL FUND TRANSFE,,45582,,500000,940008,.
23468455482,45582,INDO GIBL Indiaforensic STL26101,,45582,208000,,732008,.
23468455483,45582,FDRL/INTERNAL FUND TRANSFE,,45582,,500000,1232008,.
23468455484,45582,INDO GIBL Indiaforensic STL27101,,45582,291150,,940858,.
23468411232,45582,INDO GIBL Indiaforensic STL28101,,45582,24000,,916858,.
23468411232,45582,INDO GIBL Indiaforensic STL30101,,45582,141546,,775312,.
23468411232,45613,INDO GIBL Indiaforensic STL31101,,45613,80000,,695312,.
23468411232,45613,INDO GIBL Indiaforensic STL01111,,45613,46250,,649062,.
23468411232,45613,INDO GIBL Indiaforensic STL02111,,45613,42825,,606237,.
23468411233,45613,INDO GIBL Indiaforensic STL03111,,45613,179463,,426774,.
23468411234,45613,INDO GIBL Indiaforensic STL04111,,45613,18949,,407825,.
23468411235,45613,INDO GIBL Indiaforensic STL05111,,45613,91441,,316384,.
23468411236,45613,INDO GIBL Indiaforensic STL06111,,45613,147750,,168634,.
23468411237,45613,FDRL/INTERNAL FUND TRANSFE,,45613,,500000,668634,.
23468411238,45613,FDRL/INTERNAL FUND TRANSFE,,45613,,500000,1168634,.
23468411239,45613,INDO GIBL Indiaforensic STL07111,,45613,110188,,1058446,.
23468411240,45613,INDO GIBL Indiaforensic STL08111,,45613,61870,,996576,.
23468411241,45613,INDO GIBL Indiaforensic STL09111,,45613,84101,,912475,.
23468411242,45613,INDO GIBL Indiaforensic STL10111,,45613,129700,,782775,.
23468411243,45613,INDO GIBL Indiaforensic STL11111,,45613,7499,,775276,.
23468411244,45613,INDO GIBL Indiaforensic STL12111,,45613,80100,,695176,.
23468411245,45613,INDO GIBL Indiaforensic STL13111,,45613,143850,,551326,.
23468411246,45613,INDO GIBL Indiaforensic STL14111,,45613,289500,,261826,.
23468411247,45613,FDRL/INTERNAL FUND TRANSFE,,45613,,500000,761826,.
23468411248,45613,FDRL/INTERNAL FUND TRANSFE,,45613,,500000,1261826,.
23468411249,45613,INDO GIBL Indiaforensic STL16111,,45613,94900,,1166926,.
23468411250,45613,INDO GIBL Indiaforensic STL15111,,45613,224851,,942075,.
23468411251,45613,INDO GIBL Indiaforensic STL17111,,45613,284953,,657122,.
23468411252,45613,INDO GIBL Indiaforensic STL18111,,45613,115150,,541972,.
23468411253,45613,INDO GIBL Indiaforensic STL19111,,45613,40000,,501972,.
23468411254,45613,FDRL/INTERNAL FUND TRANSFE,,45613,,500000,1001972,.
23468411255,45613,INDO GIBL Indiaforensic STL20111,,45613,145900,,856072,.
23468411256,45613,INDO GIBL Indiaforensic STL21111,,45613,83251,,772821,.
23468411257,45613,INDO GIBL Indiaforensic STL22111,,45613,192200,,580621,.
23468411258,45613,INDO GIBL Indiaforensic STL23111,,45613,74799,,505822,.
23468411259,45613,FDRL/INTERNAL FUND TRANSFE,,45613,,500000,1005822,.
23468411260,45613,INDO GIBL Indiaforensic STL24117,,45613,19400,,986422,.
23468411261,45613,INDO GIBL Indiaforensic STL25117,,45613,39700,,946722,.
23468411262,45613,INDO GIBL Indiaforensic STL26117,,45613,42800,,903922,.
23468411263,45613,INDO GIBL Indiaforensic STL27111,,45613,100402,,803520,.
23468411264,45613,INDO GIBL Indiaforensic STL28111,,45613,101500,,702020,.
23468411265,45613,INDO GIBL Indiaforensic STL29111,,45613,36961,,665059,.
23468411266,45643,INDO GIBL Indiaforensic STL30111,,45643,67850,,597209,.
23468411267,45643,INDO GIBL Indiaforensic STL01121,,45643,19800,,577409,.
23468411268,45643,INDO GIBL Indiaforensic STL02121,,45643,10000,,567409,.
23468411269,45643,INDO GIBL Indiaforensic STL03121,,45643,24500,,542909,.
23468411270,45643,INDO GIBL Indiaforensic STL04121,,45643,41700,,501209,.
23468411271,45643,FDRL/INTERNAL FUND TRANSFE,,45643,,500000,1001209,.
23468411272,45643,INDO GIBL Indiaforensic STL05121,,45643,218050,,783159,.
23468411273,45643,INDO GIBL Indiaforensic STL06121,,45643,186400,,596759,.
23468411274,45643,INDO GIBL Indiaforensic STL07121,,45643,171330,,425429,.
23468411275,45643,INDO GIBL Indiaforensic STL08121,,45643,34400,,391029,.
23468411276,45643,INDO GIBL Indiaforensic STL09121,,45643,51199,,339830,.
23468411277,45643,INDO GIBL Indiaforensic STL10121,,45643,159150,,180680,.
23468411278,45643,FDRL/INTERNAL FUND TRANSFE,,45643,,500000,680680,.
23468411279,45643,FDRL/INTERNAL FUND TRANSFE,,45643,,500000,1180680,.
23468411280,45643,INDO GIBL Indiaforensic STL11121,,45643,206075,,974605,.
23468411281,45643,INDO GIBL Indiaforensic STL12121,,45643,142000,,832605,.
23468411282,45643,INDO GIBL Indiaforensic STL13121,,45643,350350,,482255,.
23468411283,45643,INDO GIBL Indiaforensic STL14121,,45643,343900,,138355,.
23468411284,45643,FDRL/INTERNAL FUND TRANSFE,,45643,,500000,638355,.
23468411285,45643,FDRL/INTERNAL FUND TRANSFE,,45643,,500000,1138355,.
23468411286,45643,INDO GIBL Indiaforensic STL15121,,45643,210500,,927855,.
23468411287,45643,INDO GIBL Indiaforensic STL17121,,45643,139500,,788355,.
23468411288,45643,INDO GIBL Indiaforensic STL16121,,45643,92550,,695805,.
23468411289,45643,FDRL/INTERNAL FUND TRANSFE,,45643,,500000,1195805,.
23468411290,45643,FDRL/INTERNAL FUND TRANSFE,,45643,,500000,1695805,.
23468411291,45643,INDO GIBL Indiaforensic STL18121,,45643,654498,,1041307,.
23468411292,45643,INDO GIBL Indiaforensic STL19121,,45643,504450,,536857,.
23468411293,45643,FDRL/INTERNAL FUND TRANSFE,,45643,,500000,1036857,.
23468411294,45643,INDO GIBL Indiaforensic STL20121,,45643,561225,,475632,.
23468411295,45643,FDRL/INTERNAL FUND TRANSFE,,45643,,500000,975632,.
23468411296,45643,FDRL/INTERNAL FUND TRANSFE,,45643,,500000,1475632,.
23468411297,45643,INDO GIBL Indiaforensic STL21121,,45643,146050,,1329582,.
23468411298,45643,INDO GIBL Indiaforensic STL22121,,45643,100300,,1229282,.
23468411299,45643,INDO GIBL Indiaforensic STL23121,,45643,62425,,1166857,.
23468411300,45643,INDO GIBL Indiaforensic STL24121,,45643,365300,,801557,.
23468411301,45643,INDO GIBL Indiaforensic STL25121,,45643,23550,,778007,.
23468411302,45643,FDRL/INTERNAL FUND TRANSFE,,45643,,500000,1278007,.
23468411303,45643,INDO GIBL Indiaforensic STL26121,,45643,259525,,1018482,.
23468411304,45643,INDO GIBL Indiaforensic STL27121,,45643,383110,,635372,.
23468411305,45643,INDO GIBL Indiaforensic STL28121,,45643,138150,,497222,.
23468411306,45643,FDRL/INTERNAL FUND TRANSFE,,45643,,500000,997222,.
23468411307,45643,INDO GIBL Indiaforensic STL29121,,45643,285399,,711823,.
23468411308,45309,INDO GIBL Indiaforensic STL31121,,45309,14000,,697823,.
23468411309,45309,INDO GIBL Indiaforensic STL30121,,45309,54250,,643573,.
23468411310,45309,INDO GIBL Indiaforensic STL01011,,45309,147500,,496073,.
23468411311,45309,FDRL/INTERNAL FUND TRANSFE,,45309,,500000,996073,.
23468411312,45309,INDO GIBL Indiaforensic STL02011,,45309,323500,,672573,.
23468411313,45309,INDO GIBL Indiaforensic STL03011,,45309,180300,,492273,.
23468411314,45309,FDRL/INTERNAL FUND TRANSFE,,45309,,500000,992273,.
23468411315,45309,FDRL/INTERNAL FUND TRANSFE,,45309,,500000,1492273,.
23468411316,45309,INDO GIBL Indiaforensic STL04011,,45309,222800,,1269473,.
23468411317,45309,INDO GIBL Indiaforensic STL05011,,45309,145450,,1124023,.
23468411318,45309,INDO GIBL Indiaforensic STL06011,,45309,182000,,942023,.
23468411319,45309,INDO GIBL Indiaforensic STL07011,,45309,205075,,736948,.
23468411320,45309,INDO GIBL Indiaforensic STL08011,,45309,170500,,566448,.
23468411321,45309,FDRL/INTERNAL FUND TRANSFE,,45309,,500000,1066448,.
23468411322,45309,INDO GIBL Indiaforensic STL09011,,45309,495252,,571196,.
23468411323,45309,INDO GIBL Indiaforensic STL10011,,45309,256600,,314596,.
23468411324,45309,FDRL/INTERNAL FUND TRANSFE,,45309,,500000,814596,.
23468411325,45309,FDRL/INTERNAL FUND TRANSFE,,45309,,500000,1314596,.
23468411326,45309,FDRL/INTERNAL FUND TRANSFE,,45309,,500000,1814596,.
23468411327,45309,FDRL/INTERNAL FUND TRANSFE,,45309,,500000,2314596,.
23468411328,45309,INDO GIBL Indiaforensic STL14011,,45309,5000,,2309596,.
23468411329,45309,INDO GIBL Indiaforensic STL11011,,45309,348200,,1961396,.
23468411330,45309,INDO GIBL Indiaforensic STL13011,,45309,112900,,1848496,.
23468411331,45309,INDO GIBL Indiaforensic STL12011,,45309,392251,,1456245,.
23468411332,45309,INDO GIBL Indiaforensic STL15011,,45309,412300,,1043945,.
23468411333,45309,INDO GIBL Indiaforensic STL16011,,45309,518375,,525570,.
23468411334,45309,INDO GIBL Indiaforensic STL19011,,45309,296450,,229120,.
23468411335,45309,FDRL/INTERNAL FUND TRANSFE,,45309,,500000,729120,.
23468411336,45309,FDRL/INTERNAL FUND TRANSFE,,45309,,500000,1229120,.
23468411337,45309,INDO GIBL Indiaforensic STL22011,,45309,274600,,954520,.
23468411338,45309,INDO GIBL Indiaforensic STL20011,,45309,159725,,794795,.
23468411339,45309,INDO GIBL Indiaforensic STL21011,,45309,69000,,725795,.
23468411340,45309,INDO GIBL Indiaforensic STL18011,,45309,244350,,481445,.
23468411341,45309,INDO GIBL Indiaforensic STL23011,,45309,224800,,256645,.
23468411342,45309,FDRL/INTERNAL FUND TRANSFE,,45309,,500000,756645,.
23468411343,45309,FDRL/INTERNAL FUND TRANSFE,,45309,,500000,1256645,.
23468411344,45309,FDRL/INTERNAL FUND TRANSFE,,45309,,500000,1756645,.
23468411345,45309,INDO GIBL Indiaforensic STL25011,,45309,135050,,1621595,.
23468411346,45309,INDO GIBL Indiaforensic STL26011,,45309,31300,,1590295,.
23468411347,45309,INDO GIBL Indiaforensic STL27011,,45309,20500,,1569795,.
23468411348,45309,INDO GIBL Indiaforensic STL28011,,45309,5500,,1564295,.
23468411349,45309,INDO GIBL Indiaforensic STL24011,,45309,204900,,1359395,.
23468411350,45309,INDO GIBL Indiaforensic STL17011,,45309,563250,,796145,.
23468411351,45309,INDO GIBL Indiaforensic STL29011,,45309,207100,,589045,.
23468411352,45309,INDO GIBL Indiaforensic STL30011,,45309,138250,,450795,.
23468411353,45340,INDO GIBL Indiaforensic STL31011,,45340,196150,,254645,.
23468411354,45340,FDRL/INTERNAL FUND TRANSFE,,45340,,500000,754645,.
23468411355,45340,FDRL/INTERNAL FUND TRANSFE,,45340,,500000,1254645,.
23468411356,45340,FDRL/INTERNAL FUND TRANSFE,,45340,,500000,1754645,.
23468411357,45340,INDO GIBL Indiaforensic STL02021,,45340,119675,,1634970,.
23468411358,45340,INDO GIBL Indiaforensic STL01021,,45340,137775,,1497195,.
23468411359,45340,INDO GIBL Indiaforensic STL03021,,45340,61500,,1435695,.
23468411360,45340,INDO GIBL Indiaforensic STL05021,,45340,138350,,1297345,.
23468411361,45340,INDO GIBL Indiaforensic STL06021,,45340,239400,,1057945,.
23468411362,45340,FDRL/INTERNAL FUND TRANSFE,,45340,,500000,1557945,.
23468411363,45340,FDRL/INTERNAL FUND TRANSFE,,45340,,500000,2057945,.
23468411364,45340,INDO GIBL Indiaforensic STL07021,,45340,271124,,1786821,.
23468411365,45340,INDO GIBL Indiaforensic STL08021,,45340,300799,,1486022,.
23468411366,45340,INDO GIBL Indiaforensic STL09021,,45340,334900,,1151122,.
23468411367,45340,INDO GIBL Indiaforensic STL10021,,45340,68250,,1082872,.
23468411368,45340,INDO GIBL Indiaforensic STL13021,,45340,307125,,775747,.
23468411369,45340,INDO GIBL Indiaforensic STL14021,,45340,475300,,300447,.
23468411370,45340,FDRL/INTERNAL FUND TRANSFE,,45340,,500000,800447,.
23468411371,45340,FDRL/INTERNAL FUND TRANSFE,,45340,,500000,1300447,.
23468411372,45340,FDRL/INTERNAL FUND TRANSFE,,45340,,500000,1800447,.
23468411373,45340,INDO GIBL Indiaforensic STL12021,,45340,594328,,1206119,.
23468411374,45340,INDO GIBL Indiaforensic STL15021,,45340,387100,,819019,.
23468411375,45340,FDRL/INTERNAL FUND TRANSFE,,45340,,500000,1319019,.
23468411376,45340,INDO GIBL Indiaforensic STL16021,,45340,710800,,608219,.
23468411377,45340,INDO GIBL Indiaforensic STL17021,,45340,385400,,222819,.
23468411378,45340,FDRL/INTERNAL FUND TRANSFE,,45340,,500000,722819,.
23468411379,45340,FDRL/INTERNAL FUND TRANSFE,,45340,,500000,1222819,.
23468411380,45340,INDO GIBL Indiaforensic STL18021,,45340,79350,,1143469,.
23468411381,45340,INDO GIBL Indiaforensic STL19021,,45340,385200,,758269,.
23468411382,45340,INDO GIBL Indiaforensic STL20021,,45340,299950,,458319,.
23468411383,45340,FDRL/INTERNAL FUND TRANSFE,,45340,,500000,958319,.
23468411384,45340,FDRL/INTERNAL FUND TRANSFE,,45340,,500000,1458319,.
23468411385,45340,INDO GIBL Indiaforensic STL21021,,45340,273500,,1184819,.
23468411386,45340,INDO GIBL Indiaforensic STL22021,,45340,237500,,947319,.
23468455644,45340,INDO GIBL Indiaforensic STL23021,,45340,277753,,669566,.
23468455645,45340,INDO GIBL Indiaforensic STL24021,,45340,70300,,599266,.
23468455646,45340,INDO GIBL Indiaforensic STL25021,,45340,62400,,536866,.
23468455647,45340,FDRL/INTERNAL FUND TRANSFE,,45340,,500000,1036866,.
23468455648,45340,FDRL/INTERNAL FUND TRANSFE,,45340,,500000,1536866,.
23468455649,45340,INDO GIBL Indiaforensic STL26021,,45340,103300,,1433566,.
23468455650,45340,INDO GIBL Indiaforensic STL27021,,45340,182450,,1251116,.
23468455651,45369,FDRL/INTERNAL FUND TRANSFE,,45369,,500000,1751116,.
23468455652,45369,FDRL/INTERNAL FUND TRANSFE,,45369,,500000,2251116,.
23468455653,45369,INDO GIBL Indiaforensic STL03031,,45369,155500,,2095616,.
23468455654,45369,INDO GIBL Indiaforensic STL28021,,45369,244350,,1851266,.
23468455655,45369,INDO GIBL Indiaforensic STL01031,,45369,202799,,1648467,.
23468455656,45369,INDO GIBL Indiaforensic STL03031,,45369,155500,,1492967,.
23468455657,45369,INDO GIBL Indiaforensic STL05031,,45369,153300,,1339667,.
23468455658,45369,INDO GIBL Indiaforensic STL06031,,45369,350150,,989517,.
23468455659,45369,INDO GIBL Indiaforensic STL07031,,45369,371900,,617617,.
23468455660,45369,INDO GIBL Indiaforensic STL08031,,45369,345930,,271687,.
23468455661,45369,FDRL/INTERNAL FUND TRANSFE,,45369,,500000,771687,.
23468455662,45369,FDRL/INTERNAL FUND TRANSFE,,45369,,500000,1271687,.
23468455663,45369,INDO GIBL Indiaforensic STL09031,,45369,390850,,880837,.
23468455664,45369,INDO GIBL Indiaforensic STL1003,,45369,85800,,795037,.
23468455665,45369,INDO GIBL Indiaforensic STL11031,,45369,45000,,750037,.
23468455666,45369,FDRL/INTERNAL FUND TRANSFE,,45369,,500000,1250037,.
23468455667,45369,FDRL/INTERNAL FUND TRANSFE,,45369,,500000,1750037,.
23468455668,45369,INDO GIBL Indiaforensic STL12031,,45369,577493,,1172544,.
23468455669,45369,INDO GIBL Indiaforensic STL13031,,45369,556224,,616320,.
23468455670,45369,FDRL/INTERNAL FUND TRANSFE,,45369,,500000,1116320,.
23468455671,45369,FDRL/INTERNAL FUND TRANSFE,,45369,,500000,1616320,.
23468455672,45369,INDO GIBL Indiaforensic STL14031,,45369,425700,,1190620,.
23468455673,45369,INDO GIBL Indiaforensic STL15031,,45369,213463,,977157,.
23468455674,45369,FDRL/INTERNAL FUND TRANSFE,,45369,,500000,1477157,.
23468455675,45369,INDO GIBL Indiaforensic STL16031,,45369,199983,,1277174,.
23468455676,45369,INDO GIBL Indiaforensic STL17031,,45369,230510,,1046664,.
23468455677,45369,INDO GIBL Indiaforensic STL18031,,45369,10000,,1036664,.
23468455678,45369,INDO GIBL Indiaforensic STL19031,,45369,335250,,701414,.
23468455679,45369,FDRL/INTERNAL FUND TRANSFE,,45369,,500000,1201414,.
23468455680,45369,Indfor INCM INDO REVREMI0303,,45369,,1320,1202734,.
23468455681,45369,INDO GIBLOXGN REVSTL03031,,45369,,155500,1358234,.
23468455682,45369,Indfor INCM INDO REVREMI0103,,45369,,202799,1561033,.
23468455683,45369,INDO GIBL Indiaforensic STL01031,,45369,200799,,1360234,.
23468455684,45369,INDO GIBL Indiaforensic STL20031,,45369,434450,,925784,.
23468455685,45369,INDO GIBL Indiaforensic STL21031,,45369,292175,,633609,.
23468455686,45369,FDRL/INTERNAL FUND TRANSFE,,45369,,500000,1133609,.
23468455687,45369,FDRL/INTERNAL FUND TRANSFE,,45369,,500000,1633609,.
23468455688,45369,INDO GIBL Indiaforensic STL22031,,45369,301200,,1332409,.
23468455689,45369,FDRL/INTERNAL FUND TRANSFE,,45369,,500000,1832409,.
23468455690,45369,INDO GIBL Indiaforensic STL23031,,45369,218975,,1613434,.
23468455691,45369,INDO GIBL Indiaforensic STL24031,,45369,44800,,1568634,.
23468455692,45369,INDO GIBL Indiaforensic STL25031,,45369,12000,,1556634,.
23468455693,45369,INDO GIBL Indiaforensic STL26031,,45369,259150,,1297484,.
23468455694,45369,INDO GIBL Indiaforensic STL27031,,45369,139650,,1157834,.
23468455695,45369,INDO GIBL Indiaforensic STL28031,,45369,164600,,993234,.
23468455696,45369,INDO GIBL Indiaforensic STL29031,,45369,81675,,911559,.
23468455697,45369,INDO GIBL Indiaforensic STL30031,,45369,85750,,825809,.
23468455698,45369,FDRL/INTERNAL FUND TRANSFE,,45369,,500000,1325809,.
23468455699,45400,FDRL/INTERNAL FUND TRANSFE,,45400,,500000,1825809,.
23468455700,45400,FDRL/INTERNAL FUND TRANSFE,,45400,,500000,2325809,.
23468455701,45400,INDO GIBL Indiaforensic STL31031,,45400,150950,,2174859,.
23468455702,45400,INDO GIBL Indiaforensic STL01041,,45400,20000,,2154859,.
23468455703,45400,INDO GIBL Indiaforensic STL02041,,45400,26400,,2128459,.
23468455704,45400,INDO GIBL Indiaforensic STL03041,,45400,109650,,2018809,.
23468455705,45400,INDO GIBL Indiaforensic STL04041,,45400,318100,,1700709,.
23468455706,45400,INDO GIBL Indiaforensic STL05041,,45400,309200,,1391509,.
23468455707,45400,INDO GIBL Indiaforensic STL06041,,45400,303600,,1087909,.
23468455708,45400,INDO GIBL Indiaforensic STL07041,,45400,48800,,1039109,.
23468455709,45400,FDRL/INTERNAL FUND TRANSFE,,45400,,500000,1539109,.
23468455710,45400,INDO GIBL Indiaforensic STL09041,,45400,305950,,1233159,.
23468455711,45400,FDRL/INTERNAL FUND TRANSFE,,45400,,500000,1733159,.
23468455712,45400,INDO GIBL Indiaforensic STL10041,,45400,162600,,1570559,.
23468455713,45400,INDO GIBL Indiaforensic STL11041,,45400,639700,,930859,.
23468455714,45400,FDRL/INTERNAL FUND TRANSFE,,45400,,500000,1430859,.
23468455715,45400,INDO GIBL Indiaforensic STL12041,,45400,363900,,1066959,.
23468455716,45400,FDRL/INTERNAL FUND TRANSFE,,45400,,500000,1566959,.
23468455717,45400,FDRL/INTERNAL FUND TRANSFE,,45400,,500000,2066959,.
23468455718,45400,INDO GIBL Indiaforensic STL13041,,45400,347950,,1719009,.
23468455719,45400,INDO GIBL Indiaforensic STL14041,,45400,76900,,1642109,.
23468455720,45400,INDO GIBL Indiaforensic STL15041,,45400,48000,,1594109,.
23468455721,45400,INDO GIBL Indiaforensic STL16041,,45400,555650,,1038459,.
23468455722,45400,FDRL/INTERNAL FUND TRANSFE,,45400,,500000,1538459,.
23468455723,45400,INDO GIBL Indiaforensic STL17041,,45400,574150,,964309,.
23468455724,45400,INDO GIBL Indiaforensic STL18041,,45400,388550,,575759,.
23468455725,45400,FDRL/INTERNAL FUND TRANSFE,,45400,,500000,1075759,.
23468455726,45400,INDO GIBL Indiaforensic STL19041,,45400,276300,,799459,.
23468455727,45400,INDO GIBL Indiaforensic STL20041,,45400,167591,,631868,.
23468455728,45400,FDRL/INTERNAL FUND TRANSFE,,45400,,500000,1131868,.
23468455729,45400,FDRL/INTERNAL FUND TRANSFE,,45400,,500000,1631868,.
23468455730,45400,INDO GIBL Indiaforensic STL21041,,45400,242700,,1389168,.
23468455731,45400,INDO GIBL Indiaforensic STL22041,,45400,92900,,1296268,.
23468455732,45400,INDO GIBL Indiaforensic STL23041,,45400,315750,,980518,.
23468455733,45400,INDO GIBL Indiaforensic STL24041,,45400,377300,,603218,.
23468455734,45400,FDRL/INTERNAL FUND TRANSFE,,45400,,500000,1103218,.
23445455735,45400,FDRL/INTERNAL FUND TRANSFE,,45400,,500000,1603218,.
23445455735,45400,INDO GIBL Indiaforensic STL25041,,45400,414276,,1188942,.
23445455735,45400,INDO GIBL Indiaforensic STL26041,,45400,351100,,837842,.
23445455735,45400,FDRL/INTERNAL FUND TRANSFE,,45400,,500000,1337842,.
23445455735,45430,FDRL/INTERNAL FUND TRANSFE,,45430,,500000,1837842,.
23445455736,45430,INDO GIBL Indiaforensic STL27041,,45430,229949,,1607893,.
23445455737,45430,INDO GIBL Indiaforensic STL28041,,45430,160300,,1447593,.
23445455738,45430,INDO GIBL Indiaforensic STL29041,,45430,76000,,1371593,.
23445455739,45430,INDO GIBL Indiaforensic STL30041,,45430,60449,,1311144,.
23445455740,45430,INDO GIBL Indiaforensic STL01051,,45430,259075,,1052069,.
23445455741,45430,FDRL/INTERNAL FUND TRANSFE,,45430,,500000,1552069,.
23445455742,45430,INDO GIBL Indiaforensic STL02051,,45430,206700,,1345369,.
23445455743,45430,FDRL/INTERNAL FUND TRANSFE,,45430,,500000,1845369,.
23445455744,45430,INDO GIBL Indiaforensic STL03051,,45430,237000,,1608369,.
23445455745,45430,INDO GIBL Indiaforensic STL04051,,45430,272000,,1336369,.
23445455746,45430,INDO GIBL Indiaforensic STL05051,,45430,387749,,948620,.
23445455747,45430,INDO GIBL Indiaforensic STL06051,,45430,101050,,847570,.
23445455748,45430,FDRL/INTERNAL FUND TRANSFE,,45430,,500000,1347570,.
23445455749,45430,INDO GIBL Indiaforensic STL07051,,45430,392900,,954670,.
23445455750,45430,INDO GIBL Indiaforensic STL08051,,45430,290350,,664320,.
23445455751,45430,FDRL/INTERNAL FUND TRANSFE,,45430,,500000,1164320,.
23445455752,45430,FDRL/INTERNAL FUND TRANSFE,,45430,,500000,1664320,.
23445455753,45430,INDO GIBL Indiaforensic STL09051,,45430,365625,,1298695,.
23445455754,45430,INDO GIBL Indiaforensic STL10051,,45430,352850,,945845,.
23445455755,45430,FDRL/INTERNAL FUND TRANSFE,,45430,,500000,1445845,.
23445455756,45430,INDO GIBL Indiaforensic STL11051,,45430,345749,,1100096,.
23445455757,45430,INDO GIBL Indiaforensic STL12051,,45430,225300,,874796,.
23445455758,45430,INDO GIBL Indiaforensic STL13051,,45430,10000,,864796,.
23445455759,45430,FDRL/INTERNAL FUND TRANSFE,,45430,,500000,1364796,.
23445455760,45430,INDO GIBL Indiaforensic STL14051,,45430,823240,,541556,.
23445455761,45430,FDRL/INTERNAL FUND TRANSFE,,45430,,500000,1041556,.
23445455762,45430,FDRL/INTERNAL FUND TRANSFE,,45430,,500000,1541556,.
23445455763,45430,INDO GIBL Indiaforensic STL15051,,45430,785049,,756507,.
23445455764,45430,FDRL/INTERNAL FUND TRANSFE,,45430,,500000,1256507,.
23445455765,45430,INDO GIBL Indiaforensic STL16051,,45430,403100,,853407,.
23445455766,45430,FDRL/INTERNAL FUND TRANSFE,,45430,,500000,1353407,.
23445455767,45430,INDO GIBL Indiaforensic STL17051,,45430,459800,,893607,.
23445455768,45430,FDRL/INTERNAL FUND TRANSFE,,45430,,500000,1393607,.
23445455769,45430,INDO GIBL Indiaforensic STL18051,,45430,373850,,1019757,.
23445455770,45430,INDO GIBL Indiaforensic STL19051,,45430,265500,,754257,.
23445455771,45430,INDO GIBL Indiaforensic STL20051,,45430,25700,,728557,.
23445455772,45430,FDRL/INTERNAL FUND TRANSFE,,45430,,500000,1228557,.
23445455773,45430,INDO GIBL Indiaforensic STL21051,,45430,376125,,852432,.
23445455774,45430,FDRL/INTERNAL FUND TRANSFE,,45430,,500000,1352432,.
23445455775,45430,INDO GIBL Indiaforensic STL22051,,45430,265250,,1087182,.
23445455776,45430,INDO GIBL Indiaforensic STL23051,,45430,119100,,968082,.
23445455777,45430,FDRL/INTERNAL FUND TRANSFE,,45430,,500000,1468082,.
23445455778,45430,INDO GIBL Indiaforensic STL24051,,45430,93350,,1374732,.
23445455779,45430,INDO GIBL Indiaforensic STL25051,,45430,201000,,1173732,.
23445455780,45430,INDO GIBL Indiaforensic STL26051,,45430,80475,,1093257,.
23445455781,45430,INDO GIBL Indiaforensic STL27051,,45430,27200,,1066057,.
23445455782,45430,FDRL/INTERNAL FUND TRANSFE,,45430,,500000,1566057,.
23445455783,45430,INDO GIBL Indiaforensic STL28051,,45430,364100,,1201957,.
23445455784,45430,INDO GIBL Indiaforensic STL29051,,45430,341200,,860757,.
23445455785,45430,FDRL/INTERNAL FUND TRANSFE,,45430,,500000,1360757,.
23445455786,45430,INDO GIBL Indiaforensic STL30051,,45430,234600,,1126157,.
23445455787,45461,FDRL/INTERNAL FUND TRANSFE,,45461,,500000,1626157,.
23445455788,45461,INDO GIBL Indiaforensic STL31051,,45461,78000,,1548157,.
23445455789,45461,INDO GIBL Indiaforensic STL01061,,45461,353500,,1194657,.
23445455790,45461,FDRL/INTERNAL FUND TRANSFE,,45461,,500000,1694657,.
23445455791,45461,INDO GIBL Indiaforensic STL02061,,45461,402850,,1291807,.
23445455792,45461,INDO GIBL Indiaforensic STL04061,,45461,578750,,713057,.
23445455793,45461,INDO GIBL Indiaforensic STL05061,,45461,251200,,461857,.
23445455794,45461,FDRL/INTERNAL FUND TRANSFE,,45461,,500000,961857,.
23445455795,45461,FDRL/INTERNAL FUND TRANSFE,,45461,,500000,1461857,.
23445455796,45461,INDO GIBL Indiaforensic STL06061,,45461,217075,,1244782,.
23445455797,45461,INDO GIBL Indiaforensic STL07061,,45461,491005,,753777,.
23445455798,45461,FDRL/INTERNAL FUND TRANSFE,,45461,,500000,1253777,.
23445455799,45461,FDRL/INTERNAL FUND TRANSFE,,45461,,500000,1753777,.
23445455800,45461,INDO GIBL Indiaforensic STL08061,,45461,626600,,1127177,.
23445455801,45461,INDO GIBL Indiaforensic STL09061,,45461,340074,,787103,.
23445455802,45461,INDO GIBL Indiaforensic STL10061,,45461,24176,,762927,.
23445455803,45461,FDRL/INTERNAL FUND TRANSFE,,45461,,500000,1262927,.
23445455804,45461,FDRL/INTERNAL FUND TRANSFE,,45461,,500000,1762927,.
23445455805,45461,INDO GIBL Indiaforensic STL11061,,45461,793251,,969676,.
23445455806,45461,FDRL/INTERNAL FUND TRANSFE,,45461,,500000,1469676,.
23445455807,45461,INDO GIBL Indiaforensic STL12061,,45461,717850,,751826,.
23445455808,45461,INDO GIBL Indiaforensic STL27041,,45461,32000,,719826,.
23445455809,45461,FDRL/INTERNAL FUND TRANSFE,,45461,,500000,1219826,.
23445455810,45461,FDRL/INTERNAL FUND TRANSFE,,45461,,1000000,2219826,.
23445455811,45461,INDO GIBL Indiaforensic STL13061,,45461,533800,,1686026,.
23445455812,45461,INDO GIBL Indiaforensic STL14061,,45461,559730,,1126296,.
23445455813,45461,FDRL/INTERNAL FUND TRANSFE,,45461,,1000000,2126296,.
23445455814,45461,INDO GIBL Indiaforensic STL17061,,45461,52250,,2074046,.
23445455815,45461,INDO GIBL Indiaforensic STL16061,,45461,140750,,1933296,.
23445455816,45461,INDO GIBL Indiaforensic STL15061,,45461,325200,,1608096,.
23445455817,45461,FDRL/INTERNAL FUND TRANSFE,,45461,,500000,2108096,.
23445455818,45461,INDO GIBL Indiaforensic STL18061,,45461,709200,,1398896,.
23445455819,45461,FDRL/INTERNAL FUND TRANSFE,,45461,,500000,1898896,.
23445455820,45461,INDO GIBL Indiaforensic STL19061,,45461,689650,,1209246,.
23445455821,45461,FDRL/INTERNAL FUND TRANSFE,,45461,,500000,1709246,.
23445455822,45461,INDO GIBL Indiaforensic STL20061,,45461,386200,,1323046,.
23445455823,45461,INDO GIBL Indiaforensic STL21061,,45461,434905,,888141,.
23445455824,45461,FDRL/INTERNAL FUND TRANSFE,,45461,,1000000,1888141,.
23445455825,45461,INDO GIBL Indiaforensic STL24061,,45461,6050,,1882091,.
23445455826,45461,INDO GIBL Indiaforensic STL23061,,45461,115051,,1767040,.
23445455827,45461,INDO GIBL Indiaforensic STL22061,,45461,242750,,1524290,.
23445455828,45461,TRF FROM  Indiaforensic SERVICES,,45461,,500000,2024290,.
23445455829,45461,INDO GIBL Indiaforensic STL25061,,45461,261438,,1762852,.
23445455830,45461,INDO GIBL Indiaforensic STL26061,,45461,528175,,1234677,.
23445455831,45461,FDRL/INTERNAL FUND TRANSFE,,45461,,500000,1734677,.
23445455832,45461,GIBLRBL INC INDO REM27061,,45461,2640,,1732037,.
23445455833,45461,INDO MFL STL270618,,45461,344750,,1387287,.
23445455834,45461,Indfor INCOME INDO REMI28061,,45461,2160,,1385127,.
23445455835,45461,INDO GIBL Indiaforensic STL28061,,45461,410181,,974946,.
23445455836,45461,FDRL/INTERNAL FUND TRANSFE,,45461,,500000,1474946,.
23445455837,45461,Indfor INCOME INDO REMI29061,,45461,1320,,1473626,.
23445455838,45461,INDO GIBL Indiaforensic STL29061,,45461,176050,,1297576,.
23445455839,45491,FDRL/INTERNAL FUND TRANSFE,,45491,,500000,1797576,.
23445455840,45491,Indfor INCOME INDO REMI30061,,45491,960,,1796616,.
23445455841,45491,INDO GIBL Indiaforensic STL30061,,45491,200250,,1596366,.
23445455842,45491,Indfor INCOME INDO REMI01071,,45491,120,,1596246,.
23445455843,45491,INDO GIBL Indiaforensic STL01071,,45491,10000,,1586246,.
23445455844,45491,Indfor INCOME INDO REMI02071,,45491,2280,,1583966,.
23445455845,45491,INDO GIBL Indiaforensic STL02071,,45491,282208,,1301758,.
23445455846,45491,FDRL/INTERNAL FUND TRANSFE,,45491,,500000,1801758,.
23445455847,45491,Indfor INCOME INDO REMI03071,,45491,2280,,1799478,.
23445455848,45491,INDO GIBL Indiaforensic STL03071,,45491,323700,,1475778,.
23445455849,45491,Indfor INCOME INDO REMI04071,,45491,3840,,1471938,.
23468455854,45491,INDO GIBL Indiaforensic STL04071,,45491,528300,,943638,.
23468455855,45491,Indfor INCOME INDO REMI05071,,45491,2520,,941118,.
23468455856,45491,INDO GIBL Indiaforensic STL05071,,45491,431899,,509219,.
23468455857,45491,FDRL/INTERNAL FUND TRANSFE,,45491,,500000,1009219,.
23468455858,45491,Indfor INCOME INDO REMI06071,,45491,2640,,1006579,.
23468455859,45491,INDO GIBL Indiaforensic STL06071,,45491,295000,,711579,.
23468455860,45491,FDRL/INTERNAL FUND TRANSFE,,45491,,500000,1211579,.
23468455861,45491,Indfor INCOME INDO REMI08071,,45491,120,,1211459,.
23468455862,45491,INDO GIBL Indiaforensic STL08071,,45491,30700,,1180759,.
23468455863,45491,Indfor INCOME INDO REMI07071,,45491,1200,,1179559,.
23468455864,45491,INDO GIBL Indiaforensic STL07071,,45491,213225,,966334,.
23468455865,45491,FDRL/INTERNAL FUND TRANSFE,,45491,,500000,1466334,.
23468455866,45491,Indfor INCOME INDO REMI09071,,45491,4800,,1461534,.
23468455867,45491,INDO GIBL Indiaforensic STL09071,,45491,809926,,651608,.
23468455868,45491,FDRL/INTERNAL FUND TRANSFE,,45491,,500000,1151608,.
23468455869,45491,Indfor INCOME INDO REMI10071,,45491,2640,,1148968,.
23468455870,45491,INDO GIBL Indiaforensic STL10071,,45491,435225,,713743,.
23468455871,45491,FDRL/INTERNAL FUND TRANSFE,,45491,,500000,1213743,.
23468455872,45491,FDRL/INTERNAL FUND TRANSFE,,45491,,500000,1713743,.
23468455873,45491,Indfor INCOME INDO REMI11071,,45491,4560,,1709183,.
23468455874,45491,INDO GIBL Indiaforensic STL11071,,45491,828988,,880195,.
23468455875,45491,FDRL/INTERNAL FUND TRANSFE,,45491,,500000,1380195,.
23468455876,45491,Indfor INCOME INDO REMI12071,,45491,3120,,1377075,.
23468455877,45491,INDO GIBL Indiaforensic STL12071,,45491,447455,,929620,.
23468455878,45491,FDRL/INTERNAL FUND TRANSFE,,45491,,500000,1429620,.
23468455879,45491,FDRL/INTERNAL FUND TRANSFE,,45491,,200000,1629620,.
23468455880,45491,Indfor INCOME INDO REMI15071,,45491,360,,1629260,.
23468455881,45491,INDO GIBL Indiaforensic STL15071,,45491,69800,,1559460,.
23468455882,45491,Indfor INCOME INDO REMI14071,,45491,840,,1558620,.
23468455883,45491,INDO GIBL Indiaforensic STL14071,,45491,121300,,1437320,.
23468455884,45491,Indfor INCOME INDO REMI13071,,45491,3000,,1434320,.
23468455885,45491,INDO GIBL Indiaforensic STL13071,,45491,505300,,929020,.
23468455886,45491,FDRL/INTERNAL FUND TRANSFE,,45491,,200000,1129020,.
23468455887,45491,FDRL/INTERNAL FUND TRANSFE,,45491,,500000,1629020,.
23468455888,45491,Indfor INCOME INDO REMI16071,,45491,4080,,1624940,.
23213455889,45491,INDO GIBL Indiaforensic STL16071,,45491,717000,,907940,.
23213455889,45491,FDRL/INTERNAL FUND TRANSFE,,45491,,200000,1107940,.
23213455889,45491,FDRL/INTERNAL FUND TRANSFE,,45491,,200000,1307940,.
23213455889,45491,Indfor INCOME INDO REMI17071,,45491,3960,,1303980,.
23213455889,45491,INDO GIBL Indiaforensic STL17071,,45491,581900,,722080,.
23213455889,45491,FDRL/INTERNAL FUND TRANSFE,,45491,,200000,922080,.
23213455889,45491,FDRL/INTERNAL FUND TRANSFE,,45491,,200000,1122080,.
23213455889,45491,FDRL/INTERNAL FUND TRANSFE,,45491,,200000,1322080,.
23213455889,45491,FDRL/INTERNAL FUND TRANSFE,,45491,,200000,1522080,.
23213455889,45491,FDRL/INTERNAL FUND TRANSFE,,45491,,200000,1722080,.
23213455890,45491,FDRL/INTERNAL FUND TRANSFE,,45491,,200000,1922080,.
23213455891,45491,Indfor INCOME INDO REMI18071,,45491,3600,,1918480,.
23213455892,45491,INDO GIBL Indiaforensic STL18071,,45491,663350,,1255130,.
23213455893,45491,Indfor INCOME INDO REMI19071,,45491,1440,,1253690,.
23213455894,45491,INDO GIBL Indiaforensic STL19071,,45491,135800,,1117890,.
23213455895,45491,FDRL/INTERNAL FUND TRANSFE,,45491,,300000,1417890,.
23213455896,45491,Indfor INCOME INDO REMI20071,,45491,3600,,1414290,.
23213455897,45491,INDO GIBL Indiaforensic STL20071,,45491,712099,,702191,.
23213455898,45491,FDRL/INTERNAL FUND TRANSFE,,45491,,1000000,1702191,.
23213455899,45491,FDRL/INTERNAL FUND TRANSFE,,45491,,300000,2002191,.
23213455900,45491,Indfor INCOME INDO REMI22071,,45491,840,,2001351,.
23213455901,45491,INDO GIBL Indiaforensic STL22071,,45491,145400,,1855951,.
23213455902,45491,Indfor INCOME INDO REMI21071,,45491,1920,,1854031,.
23213455903,45491,INDO GIBL Indiaforensic STL21071,,45491,240535,,1613496,.
23213455904,45491,Indfor INCOME INDO REMI23071,,45491,3840,,1609656,.
23213455905,45491,INDO GIBL Indiaforensic STL23071,,45491,610100,,999556,.
23213455906,45491,FDRL/INTERNAL FUND TRANSFE,,45491,,500000,1499556,.
23213455907,45491,Indfor INCOME INDO REMI24071,,45491,3360,,1496196,.
23213455908,45491,INDO GIBL Indiaforensic STL24071,,45491,518500,,977696,.
23213455909,45491,FDRL/INTERNAL FUND TRANSFE,,45491,,300000,1277696,.
23213455910,45491,FDRL/INTERNAL FUND TRANSFE,,45491,,300000,1577696,.
23213455911,45491,Indfor INCOME INDO REMI25071,,45491,3240,,1574456,.
23213455912,45491,INDO GIBL Indiaforensic STL25071,,45491,442250,,1132206,.
23213455913,45491,FDRL/INTERNAL FUND TRANSFE,,45491,,300000,1432206,.
23213455914,45491,Indfor INCOME INDO REMI26071,,45491,3240,,1428966,.
23213455915,45491,INDO GIBL Indiaforensic STL26071,,45491,389600,,1039366,.
23213455916,45491,FDRL/INTERNAL FUND TRANSFE,,45491,,1000000,2039366,.
23213455917,45491,Indfor INCOME INDO REMI27071,,45491,2760,,2036606,.
23213455918,45491,INDO GIBL Indiaforensic STL27071,,45491,457875,,1578731,.
23213455919,45491,Indfor INCOME INDO REMI28071,,45491,600,,1578131,.
23213455920,45491,INDO GIBL Indiaforensic STL28071,,45491,66800,,1511331,.
23213455921,45491,Indfor INCOME INDO REMI30071,,45491,2280,,1509051,.
23213455922,45491,INDO GIBL Indiaforensic STL30071,,45491,341400,,1167651,.
23213455923,45491,FDRL/INTERNAL FUND TRANSFE,,45491,,300000,1467651,.
23213455924,45522,Indfor INCOME INDO REMI31071,,45522,2760,,1464891,.
23213455925,45522,INDO GIBL Indiaforensic STL31071,,45522,372350,,1092541,.
23213455926,45522,FDRL/INTERNAL FUND TRANSFE,,45522,,300000,1392541,.
23213455927,45522,Indfor INCOME INDO REMI01081,,45522,1080,,1391461,.
23213455928,45522,INDO GIBL Indiaforensic STL01081,,45522,145500,,1245961,.
23213455929,45522,FDRL/INTERNAL FUND TRANSFE,,45522,,300000,1545961,.
23213455930,45522,Indfor INCOME INDO REMI02081,,45522,840,,1545121,.
23213455931,45522,INDO GIBL Indiaforensic STL02081,,45522,110550,,1434571,.
23213455932,45522,Indfor INCOME INDO REMI03081,,45522,1200,,1433371,.
23213455933,45522,INDO GIBL Indiaforensic STL03081,,45522,220801,,1212570,.
23213455934,45522,Indfor INCOME INDO REMI04081,,45522,1560,,1211010,.
23213455935,45522,INDO GIBL Indiaforensic STL04081,,45522,269850,,941160,.
23213455936,45522,Indfor INCOME INDO REMI05081,,45522,240,,940920,.
23213455937,45522,INDO GIBL Indiaforensic STL05081,,45522,17500,,923420,.
23213455938,45522,FDRL/INTERNAL FUND TRANSFE,,45522,,500000,1423420,.
23213455939,45522,Indfor INCOME INDO REMI06081,,45522,3720,,1419700,.
23213455940,45522,INDO GIBL Indiaforensic STL06081,,45522,457050,,962650,.
23213455941,45522,FDRL/INTERNAL FUND TRANSFE,,45522,,300000,1262650,.
23213455942,45522,FDRL/INTERNAL FUND TRANSFE,,45522,,300000,1562650,.
23213455943,45522,Indfor INCOME INDO REMI07081,,45522,3840,,1558810,.
23213455944,45522,INDO GIBL Indiaforensic STL07081,,45522,662025,,896785,.
23213455945,45522,FDRL/INTERNAL FUND TRANSFE,,45522,,500000,1396785,.
23213455946,45522,Indfor INCOME INDO REMI08081,,45522,3480,,1393305,.
23213455947,45522,INDO GIBL Indiaforensic STL08081,,45522,556450,,836855,.
23213455948,45522,FDRL/INTERNAL FUND TRANSFE,,45522,,500000,1336855,.
23213455949,45522,Indfor INCOME INDO REMI09081,,45522,2280,,1334575,.
23213455950,45522,INDO GIBL Indiaforensic STL09081,,45522,336850,,997725,.
23213455951,45522,FDRL/INTERNAL FUND TRANSFE,,45522,,1000000,1997725,.
23213455952,45522,Indfor INCOME INDO REMI10081,,45522,2520,,1995205,.
23213455953,45522,INDO GIBL Indiaforensic STL10081,,45522,351200,,1644005,.
23213455954,45522,Indfor INCOME INDO REMI11081,,45522,1320,,1642685,.
23213455955,45522,INDO GIBL Indiaforensic STL11081,,45522,200700,,1441985,.
23213455956,45522,Indfor INCOME INDO REMI12081,,45522,840,,1441145,.
23213455957,45522,INDO GIBL Indiaforensic STL12081,,45522,116260,,1324885,.
23468455967,45522,Indfor INCOME INDO REMI13081,,45522,3480,,1321405,.
23468455968,45522,INDO GIBL Indiaforensic STL13081,,45522,517655,,803750,.
23468455969,45522,FDRL/INTERNAL FUND TRANSFE,,45522,,1000000,1803750,.
23468455970,45522,Indfor INCOME INDO REMI14081,,45522,3600,,1800150,.
23468455971,45522,INDO GIBL Indiaforensic STL14081,,45522,561995,,1238155,.
23468455972,45522,Indfor INCOME INDO REMI15081,,45522,1320,,1236835,.
23468455973,45522,INDO GIBL Indiaforensic STL15081,,45522,212000,,1024835,.
23468455974,45522,FDRL/INTERNAL FUND TRANSFE,,45522,,500000,1524835,.
23468455975,45522,Indfor INCOME INDO REMI16081,,45522,4440,,1520395,.
23468455976,45522,INDO GIBL Indiaforensic STL16081,,45522,755505,,764890,.
23468455977,45522,FDRL/INTERNAL FUND TRANSFE,,45522,,400000,1164890,.
23468455978,45522,Indfor INCOME INDO REMI17081,,45522,3960,,1160930,.
23468455979,45522,INDO GIBL Indiaforensic STL17081,,45522,615328,,545602,.
23468455980,45522,FDRL/INTERNAL FUND TRANSFE,,45522,,500000,1045602,.
23468455981,45522,FDRL/INTERNAL FUND TRANSFE,,45522,,500000,1545602,.
23468455982,45522,Indfor INCOME INDO REMI18081,,45522,1920,,1543682,.
23468455983,45522,INDO GIBL Indiaforensic STL18081,,45522,262900,,1280782,.
23468455984,45522,Indfor INCOME INDO REMI19081,,45522,360,,1280422,.
23468455985,45522,INDO GIBL Indiaforensic STL19081,,45522,18000,,1262422,.
23468455986,45522,FDRL/INTERNAL FUND TRANSFE,,45522,,400000,1662422,.
23468455987,45522,Indfor INCOME INDO REMI20081,,45522,4200,,1658222,.
23468455988,45522,INDO GIBL Indiaforensic STL20081,,45522,554751,,1103471,.
23468455989,45522,FDRL/INTERNAL FUND TRANSFE,,45522,,400000,1503471,.
23468455990,45522,FDRL/INTERNAL FUND TRANSFE,,45522,,400000,1903471,.
23468455991,45522,Indfor INCOME INDO REMI21081,,45522,5280,,1898191,.
23468455992,45522,INDO GIBL Indiaforensic STL21081,,45522,912000,,986191,.
23468455993,45522,Indfor INCOME INDO REMI22081,,45522,1800,,984391,.
23468455994,45522,INDO GIBL Indiaforensic STL22081,,45522,335601,,648790,.
23468455995,45522,FDRL/INTERNAL FUND TRANSFE,,45522,,400000,1048790,.
23468455996,45522,Indfor INCOME INDO REMI23081,,45522,2400,,1046390,.
23468455997,45522,INDO GIBL Indiaforensic STL23081,,45522,338131,,708259,.
24521255998,45522,FDRL/INTERNAL FUND TRANSFE,,45522,,400000,1108259,.
24521255998,45522,FDRL/INTERNAL FUND TRANSFE,,45522,,400000,1508259,.
24521255998,45522,Indfor INCOME INDO REMI24081,,45522,1560,,1506699,.
24521255998,45522,INDO GIBL Indiaforensic STL24081,,45522,230300,,1276399,.
24521255998,45522,Indfor INCOME INDO REMI25081,,45522,720,,1275679,.
24521255998,45522,INDO GIBL Indiaforensic STL25081,,45522,71080,,1204599,.
24521255998,45522,FDRL/INTERNAL FUND TRANSFE,,45522,,400000,1604599,.
24521255998,45522,Indfor INCOME INDO REMI27081,,45522,4320,,1600279,.
24521255998,45522,INDO GIBL Indiaforensic STL27081,,45522,518401,,1081878,.
24521255998,45522,FDRL/INTERNAL FUND TRANSFE,,45522,,400000,1481878,.
24521255998,45522,Indfor INCOME INDO REMI28081,,45522,2160,,1479718,.
24521255999,45522,INDO GIBL Indiaforensic STL28081,,45522,254584,,1225134,.
24521256000,45522,FDRL/INTERNAL FUND TRANSFE,,45522,,400000,1625134,.
24521256001,45522,Indfor INCOME INDO REMI29081,,45522,2760,,1622374,.
24521256002,45522,INDO GIBL Indiaforensic STL29081,,45522,350585,,1271789,.
24521256003,45522,Indfor INCOME INDO REMI30081,,45522,2280,,1269509,.
24521256004,45522,INDO GIBL Indiaforensic STL30081,,45522,360425,,909084,.
24521256005,45522,FDRL/INTERNAL FUND TRANSFE,,45522,,500000,1409084,.
24521256006,45553,Indfor INCOME INDO REMI31081,,45553,3000,,1406084,.
24521256007,45553,INDO WEIZ STL310818,,45553,414101,,991983,.
24521256008,45553,FDRL/INTERNAL FUND TRANSFE,,45553,,500000,1491983,.
24521256009,45553,Indfor INCOME INDO REMI01091,,45553,1440,,1490543,.
24521256010,45553,INDO GIBL Indiaforensic STL01091,,45553,236300,,1254243,.
24521256011,45553,Indfor INCOME INDO REMI02091,,45553,120,,1254123,.
24521256012,45553,INDO GIBL Indiaforensic STL02091,,45553,9800,,1244323,.
24521256013,45553,Indfor INCOME INDO REMI03091,,45553,1920,,1242403,.
24521256014,45553,INDO GIBL Indiaforensic STL03091,,45553,228025,,1014378,.
24521256015,45553,FDRL/INTERNAL FUND TRANSFE,,45553,,500000,1514378,.
24521256016,45553,Indfor INCOME INDO REMI04091,,45553,2880,,1511498,.
24521256017,45553,INDO WEIZ STL040918,,45553,368300,,1143198,.
24521256018,45553,Indfor INCOME INDO REMI05091,,45553,2880,,1140318,.
24521256019,45553,INDO GIBL Indiaforensic STL05091,,45553,406628,,733690,.
24521256020,45553,FDRL/INTERNAL FUND TRANSFE,,45553,,500000,1233690,.
24521256021,45553,Indfor INCOME INDO REMI06091,,45553,2760,,1230930,.
24521256022,45553,INDO GIBL Indiaforensic STL06091,,45553,377198,,853732,.
24521256023,45553,FDRL/INTERNAL FUND TRANSFE,,45553,,500000,1353732,.
24521256024,45553,Indfor INCOME INDO REMI07091,,45553,3240,,1350492,.
24521256025,45553,INDO GIBL Indiaforensic STL07091,,45553,441750,,908742,.
24521256026,45553,Indfor INCOME INDO REMI08091,,45553,2040,,906702,.
24521256027,45553,INDO GIBL Indiaforensic STL08091,,45553,274751,,631951,.
24521256028,45553,Indfor INCOME INDO REMI09091,,45553,360,,631591,.
24521256029,45553,INDO GIBL Indiaforensic STL09091,,45553,61600,,569991,.
24521256030,45553,FDRL/INTERNAL FUND TRANSFE,,45553,,500000,1069991,.
24521256031,45553,FDRL/INTERNAL FUND TRANSFE,,45553,,500000,1569991,.
24521256032,45553,Indfor INCOME INDO REMI10091,,45553,4200,,1565791,.
24521256033,45553,INDO GIBL Indiaforensic STL10091,,45553,537776,,1028015,.
24521256034,45553,FDRL/INTERNAL FUND TRANSFE,,45553,,1000000,2028015,.
24521256035,45553,Indfor INCOME INDO REMI11091,,45553,5160,,2022855,.
24521256036,45553,INDO GIBL Indiaforensic STL11091,,45553,776577,,1246278,.
24521256037,45553,Indfor INCOME INDO REMI12091,,45553,1800,,1244478,.
24521256038,45553,INDO GIBL Indiaforensic STL12091,,45553,252025,,992453,.
24521256039,45553,Indfor INCOME INDO REMI13091,,45553,2520,,989933,.
24521256040,45553,INDO GIBL Indiaforensic STL13091,,45553,395501,,594432,.
24521256041,45553,FDRL/INTERNAL FUND TRANSFE,,45553,,1000000,1594432,.
24521256042,45553,Indfor INCOME INDO REMI14091,,45553,3720,,1590712,.
24521256043,45553,INDO GIBL Indiaforensic STL14091,,45553,543351,,1047361,.
24521256044,45553,FDRL/INTERNAL FUND TRANSFE,,45553,,500000,1547361,.
24521256045,45553,FDRL/INTERNAL FUND TRANSFE,,45553,,500000,2047361,.
24521256046,45553,Indfor INCOME INDO REMI15091,,45553,1200,,2046161,.
24521256047,45553,INDO GIBL Indiaforensic STL15091,,45553,223150,,1823011,.
24521256048,45553,Indfor INCOME INDO REMI16091,,45553,120,,1822891,.
24521256049,45553,INDO GIBL Indiaforensic STL16091,,45553,12500,,1810391,.
24521256050,45553,Indfor INCOME INDO REMI17091,,45553,3960,,1806431,.
24521256051,45553,INDO GIBL Indiaforensic STL17091,,45553,546674,,1259757,.
24521256052,45553,Indfor INCOME INDO REMI18091,,45553,3720,,1256037,.
24521256053,45553,INDO GIBL Indiaforensic STL18091,,45553,533052,,722985,.
24521256054,45553,FDRL/INTERNAL FUND TRANSFE,,45553,,500000,1222985,.
24521256055,45553,Indfor INCOME INDO REMI19091,,45553,2640,,1220345,.
24521256056,45553,INDO GIBL Indiaforensic STL19091,,45553,497477,,722868,.
24521256057,45553,FDRL/INTERNAL FUND TRANSFE,,45553,,500000,1222868,.
24521256058,45553,FDRL/INTERNAL FUND TRANSFE,,45553,,500000,1722868,.
24521256059,45553,Indfor INCOME INDO REMI20091,,45553,3120,,1719748,.
24521256060,45553,INDO GIBL Indiaforensic STL20091,,45553,503006,,1216742,.
24521256061,45553,Indfor INCOME INDO REMI21091,,45553,1800,,1214942,.
24521256062,45553,INDO GIBL Indiaforensic STL21091,,45553,255052,,959890,.
24521256063,45553,Indfor INCOME INDO REMI22091,,45553,600,,959290,.
24521256064,45553,INDO GIBL Indiaforensic STL22091,,45553,78250,,881040,.
24521256065,45553,Indfor INCOME INDO REMI23091,,45553,120,,880920,.
24521256066,45553,INDO GIBL Indiaforensic STL23091,,45553,6250,,874670,.
24521256067,45553,FDRL/INTERNAL FUND TRANSFE,,45553,,500000,1374670,.
24521256068,45553,Indfor INCOME INDO REMI24091,,45553,2280,,1372390,.
24521256069,45553,INDO GIBL Indiaforensic STL24091,,45553,345725,,1026665,.
24521256070,45553,FDRL/INTERNAL FUND TRANSFE,,45553,,500000,1526665,.
24521256071,45553,Indfor INCOME INDO REMI25091,,45553,2520,,1524145,.
24521256072,45553,INDO GIBL Indiaforensic STL25091,,45553,407252,,1116893,.
24521256073,45553,Indfor INCOME INDO REMI26091,,45553,1320,,1115573,.
24521256074,45553,INDO GIBL Indiaforensic STL26091,,45553,256050,,859523,.
24521256075,45553,FDRL/INTERNAL FUND TRANSFE,,45553,,500000,1359523,.
24521256076,45553,Indfor INCOME INDO REMI27091,,45553,2040,,1357483,.
24521256077,45553,INDO GIBL Indiaforensic STL27091,,45553,327001,,1030482,.
24521256078,45553,Indfor INCOME INDO REMI28091,,45553,1920,,1028562,.
24521256079,45553,INDO GIBL Indiaforensic STL28091,,45553,231275,,797287,.
24521256080,45583,FDRL/INTERNAL FUND TRANSFE,,45583,,500000,1297287,.
24521256081,45583,Indfor INCOME INDO REMI29091,,45583,2040,,1295247,.
24521256082,45583,INDO GIBL Indiaforensic STL29091,,45583,333800,,961447,.
24521256083,45583,Indfor INCOME INDO REMI30091,,45583,120,,961327,.
24521256084,45583,INDO GIBL Indiaforensic STL30091,,45583,5000,,956327,.
24521256085,45583,FDRL/INTERNAL FUND TRANSFE,,45583,,500000,1456327,.
24521256086,45583,Indfor INCOME INDO REMI01101,,45583,3720,,1452607,.
24521256087,45583,INDO GIBL Indiaforensic STL01101,,45583,529105,,923502,.
24521256088,45583,Indfor INCOME INDO REMI02101,,45583,1200,,922302,.
24521256089,45583,INDO GIBL Indiaforensic STL02101,,45583,225300,,697002,.
24521256090,45583,FDRL/INTERNAL FUND TRANSFE,,45583,,500000,1197002,.
24521256091,45583,FDRL/INTERNAL FUND TRANSFE,,45583,,500000,1697002,.
24521256092,45583,Indfor INCOME INDO REMI03101,,45583,3120,,1693882,.
24521256093,45583,INDO GIBL Indiaforensic STL03101,,45583,545402,,1148480,.
24521256094,45583,Indfor INCOME INDO REMI04101,,45583,1440,,1147040,.
24521256095,45583,INDO GIBL Indiaforensic STL04101,,45583,156313,,990727,.
24521256096,45583,Indfor INCOME INDO REMI05101,,45583,1320,,989407,.
24521256097,45583,INDO GIBL Indiaforensic STL05101,,45583,230751,,758656,.
24521256098,45583,FDRL/INTERNAL FUND TRANSFE,,45583,,500000,1258656,.
24521256099,45583,Indfor INCOME INDO REMI07101,,45583,480,,1258176,.
24521256100,45583,INDO GIBL Indiaforensic STL07101,,45583,56000,,1202176,.
24521256101,45583,Indfor INCOME INDO REMI06101,,45583,2280,,1199896,.
24521256102,45583,INDO GIBL Indiaforensic STL06101,,45583,282452,,917444,.
24521256103,45583,FDRL/INTERNAL FUND TRANSFE,,45583,,500000,1417444,.
24521256104,45583,Indfor INCOME INDO REMI08101,,45583,4080,,1413364,.
24521256105,45583,INDO GIBL Indiaforensic STL08101,,45583,530352,,883012,.
24521256106,45583,FDRL/INTERNAL FUND TRANSFE,,45583,,500000,1383012,.
24521256107,45583,Indfor INCOME INDO REMI09101,,45583,1920,,1381092,.
24521256108,45583,INDO GIBL Indiaforensic STL09101,,45583,315083,,1066009,.
24521256109,45583,FDRL/INTERNAL FUND TRANSFE,,45583,,500000,1566009,.
24521256110,45583,Indfor INCOME INDO REMI10101,,45583,3720,,1562289,.
24521256111,45583,INDO GIBL Indiaforensic STL10101,,45583,584951,,977338,.
24521256112,45583,FDRL/INTERNAL FUND TRANSFE,,45583,,500000,1477338,.
24521256113,45583,Indfor INCOME INDO REMI11101,,45583,4080,,1473258,.
24521256114,45583,INDO GIBL Indiaforensic STL11101,,45583,599251,,874007,.
24521256115,45583,FDRL/INTERNAL FUND TRANSFE,,45583,,500000,1374007,.
24521256116,45583,FDRL/INTERNAL FUND TRANSFE,,45583,,500000,1874007,.
24521256117,45583,Indfor INCOME INDO REMI12101,,45583,3840,,1870167,.
24521256118,45583,INDO GIBL Indiaforensic STL12101,,45583,730425,,1139742,.
24521256119,45583,Indfor INCOME INDO REMI13101,,45583,1440,,1138302,.
24521256120,45583,INDO GIBL Indiaforensic STL13101,,45583,173350,,964952,.
24521256121,45583,Indfor INCOME INDO REMI14101,,45583,360,,964592,.
24521256122,45583,INDO GIBL Indiaforensic STL14101,,45583,34500,,930092,.
24521256123,45583,FDRL/INTERNAL FUND TRANSFE,,45583,,500000,1430092,.
24521256124,45583,Indfor INCOME INDO REMI15101,,45583,5160,,1424932,.
24521256125,45583,INDO GIBL Indiaforensic STL15101,,45583,780576,,644356,.
24521256126,45583,FDRL/INTERNAL FUND TRANSFE,,45583,,200000,844356,.
24521256127,45583,FDRL/INTERNAL FUND TRANSFE,,45583,,300000,1144356,.
24521256128,45583,FDRL/INTERNAL FUND TRANSFE,,45583,,200000,1344356,.
24521256129,45583,FDRL/INTERNAL FUND TRANSFE,,45583,,300000,1644356,.
24521256130,45583,Indfor INCOME INDO REMI16101,,45583,4080,,1640276,.
24521256131,45583,INDO GIBL Indiaforensic STL16101,,45583,673628,,966648,.
24521256132,45583,FDRL/INTERNAL FUND TRANSFE,,45583,,500000,1466648,.
24521256133,45583,Indfor INCOME INDO REMI17101,,45583,1200,,1465448,.
24521256134,45583,INDO GIBL Indiaforensic STL17101,,45583,119200,,1346248,.
24521256135,45583,Indfor INCOME INDO REMI18101,,45583,1200,,1345048,.
24521256136,45583,INDO GIBL Indiaforensic STL18101,,45583,149802,,1195246,.
24521256137,45583,Indfor INCOME INDO REMI19101,,45583,480,,1194766,.
24521256138,45583,INDO GIBL Indiaforensic STL19101,,45583,56000,,1138766,.
24521256139,45583,Indfor INCOME INDO REMI20101,,45583,1200,,1137566,.
24521256140,45583,INDO GIBL Indiaforensic STL20101,,45583,223600,,913966,.
24521256141,45583,Indfor INCOME INDO REMI21101,,45583,120,,913846,.
24521256142,45583,INDO GIBL Indiaforensic STL21101,,45583,10500,,903346,.
24521256143,45583,FDRL/INTERNAL FUND TRANSFE,,45583,,500000,1403346,.
24521256144,45583,Indfor INCOME INDO REMI22101,,45583,2760,,1400586,.
24521256145,45583,INDO GIBL Indiaforensic STL22101,,45583,436678,,963908,.
24521256146,45583,FDRL/INTERNAL FUND TRANSFE,,45583,,200000,1163908,.
24521256147,45583,Indfor INCOME INDO REMI23101,,45583,2040,,1161868,.
24521256148,45583,INDO GIBL Indiaforensic STL23101,,45583,432150,,729718,.
24521256149,45583,FDRL/INTERNAL FUND TRANSFE,,45583,,500000,1229718,.
24521256150,45583,Indfor INCOME INDO REMI24101,,45583,1320,,1228398,.
24521256151,45583,INDO GIBL Indiaforensic STL24101,,45583,156401,,1071997,.
24521256152,45583,Indfor INCOME INDO REMI25101,,45583,1320,,1070677,.
24521256153,45583,INDO GIBL Indiaforensic STL25101,,45583,232683,,837994,.
24521256154,45583,FDRL/INTERNAL FUND TRANSFE,,45583,,200000,1037994,.
24521256155,45583,FDRL/INTERNAL FUND TRANSFE,,45583,,200000,1237994,.
24521256156,45583,FDRL/INTERNAL FUND TRANSFE,,45583,,200000,1437994,.
24521256157,45583,Indfor INCOME INDO REMI26101,,45583,1560,,1436434,.
24521256158,45583,INDO GIBL Indiaforensic STL26101,,45583,224800,,1211634,.
24521256159,45583,Indfor INCOME INDO REMI27101,,45583,1200,,1210434,.
24521256160,45583,INDO GIBL Indiaforensic STL27101,,45583,254250,,956184,.
24521256161,45583,Indfor INCOME INDO REMI29101,,45583,3360,,952824,.
23468456172,45583,INDO GIBL Indiaforensic STL29101,,45583,364175,,588649,.
23468456173,45583,FDRL/INTERNAL FUND TRANSFE,,45583,,200000,788649,.
23468456174,45583,FDRL/INTERNAL FUND TRANSFE,,45583,,300000,1088649,.
23468456175,45583,Indfor INCOME INDO REMI30101,,45583,2520,,1086129,.
23468456176,45583,INDO GIBL Indiaforensic STL30101,,45583,274602,,811527,.
23468456177,45583,FDRL/INTERNAL FUND TRANSFE,,45583,,200000,1011527,.
23468456178,45583,FDRL/INTERNAL FUND TRANSFE,,45583,,300000,1311527,.
23468456179,45614,Indfor INCOME INDO REMI31101,,45614,1920,,1309607,.
23468456180,45614,INDO GIBL Indiaforensic STL31101,,45614,239305,,1070302,.
23468456181,45614,Indfor INCOME INDO REMI01111,,45614,1680,,1068622,.
23468456182,45614,INDO GIBL Indiaforensic STL01111,,45614,192675,,875947,.
23468456183,45614,Indfor INCOME INDO REMI02111,,45614,2640,,873307,.
23468456184,45614,INDO GIBL Indiaforensic STL02111,,45614,369251,,504056,.
23468456185,45614,FDRL/INTERNAL FUND TRANSFE,,45614,,500000,1004056,.
23468456186,45614,Indfor INCOME INDO REMI03111,,45614,2280,,1001776,.
23468456187,45614,INDO GIBL Indiaforensic STL03111,,45614,323726,,678050,.
23468456188,45614,Indfor INCOME INDO REMI04111,,45614,840,,677210,.
23468456189,45614,INDO GIBL Indiaforensic STL04111,,45614,129000,,548210,.
23468456190,45614,FDRL/INTERNAL FUND TRANSFE,,45614,,500000,1048210,.
15643356743,45614,FDRL/INTERNAL FUND TRANSFE,,45614,,500000,1548210,.
15643356743,45614,Indfor INCOME INDO REMI05111,,45614,4920,,1543290,.
15643356743,45614,INDO GIBL Indiaforensic STL05111,,45614,807502,,735788,.
15643356743,45614,FDRL/INTERNAL FUND TRANSFE,,45614,,500000,1235788,.
15643356743,45614,FDRL/INTERNAL FUND TRANSFE,,45614,,500000,1735788,.
15643356743,45614,Indfor INCOME INDO REMI06111,,45614,4920,,1730868,.
15643356743,45614,INDO GIBL Indiaforensic STL06111,,45614,780026,,950842,.
15643356743,45614,Indfor INCOME INDO REMI07111,,45614,1320,,949522,.
15643356743,45614,INDO GIBL Indiaforensic STL07111,,45614,153513,,796009,.
15643356743,45614,Indfor INCOME INDO REMI08111,,45614,600,,795409,.
15643356744,45614,INDO GIBL Indiaforensic STL08111,,45614,102725,,692684,.
15643356745,45614,FDRL/INTERNAL FUND TRANSFE,,45614,,500000,1192684,.
15643356746,45614,FDRL/INTERNAL FUND TRANSFE,,45614,,200000,1392684,.
15643356747,45614,FDRL/INTERNAL FUND TRANSFE,,45614,,200000,1592684,.
15643356748,45614,Indfor INCOME INDO REMI09111,,45614,2040,,1590644,.
15643356749,45614,INDO GIBL Indiaforensic STL09111,,45614,478599,,1112045,.
15643356750,45614,Indfor INCOME INDO REMI11111,,45614,120,,1111925,.
15643356751,45614,INDO GIBL Indiaforensic STL11111,,45614,8000,,1103925,.
15643356752,45614,Indfor INCOME INDO REMI10111,,45614,2040,,1101885,.
15643356753,45614,INDO GIBL Indiaforensic STL10111,,45614,284926,,816959,.
15643356754,45614,FDRL/INTERNAL FUND TRANSFE,,45614,,200000,1016959,.
15643356755,45614,Indfor INCOME INDO REMI12111,,45614,2280,,1014679,.
15643356756,45614,INDO GIBL Indiaforensic STL12111,,45614,354000,,660679,.
15643356757,45614,FDRL/INTERNAL FUND TRANSFE,,45614,,200000,860679,.
15643356758,45614,FDRL/INTERNAL FUND TRANSFE,,45614,,300000,1160679,.
15643356759,45614,FDRL/INTERNAL FUND TRANSFE,,45614,,300000,1460679,.
15643356760,45614,FDRL/INTERNAL FUND TRANSFE,,45614,,200000,1660679,.
15643356761,45614,Indfor INCOME INDO REMI13111,,45614,4080,,1656599,.
15643356762,45614,INDO GIBL Indiaforensic STL13111,,45614,800876,,855723,.
15643356763,45614,FDRL/INTERNAL FUND TRANSFE,,45614,,300000,1155723,.
15643356764,45614,Indfor INCOME INDO REMI14111,,45614,2160,,1153563,.
15643356765,45614,INDO GIBL Indiaforensic STL14111,,45614,404700,,748863,.
15643356766,45614,FDRL/INTERNAL FUND TRANSFE,,45614,,300000,1048863,.
15643356767,45614,Indfor INCOME INDO REMI15111,,45614,3000,,1045863,.
15643356768,45614,INDO GIBL Indiaforensic STL15111,,45614,580226,,465637,.
15643356769,45614,FDRL/INTERNAL FUND TRANSFE,,45614,,500000,965637,.
15643356770,45614,FDRL/INTERNAL FUND TRANSFE,,45614,,300000,1265637,.
15643356771,45614,Indfor INCOME INDO REMI16111,,45614,3000,,1262637,.
15643356772,45614,INDO GIBL Indiaforensic STL16111,,45614,583076,,679561,.
15643356773,45614,FDRL/INTERNAL FUND TRANSFE,,45614,,400000,1079561,.
15643356774,45614,FDRL/INTERNAL FUND TRANSFE,,45614,,400000,1479561,.
15643356775,45614,Indfor INCOME INDO REMI18111,,45614,360,,1479201,.
15643356776,45614,INDO GIBL Indiaforensic STL18111,,45614,59700,,1419501,.
15643356777,45614,Indfor INCOME INDO REMI17111,,45614,1320,,1418181,.
15643356778,45614,INDO GIBL Indiaforensic STL17111,,45614,207463,,1210718,.
15643356779,45614,FDRL/INTERNAL FUND TRANSFE,,45614,,300000,1510718,.
15643356780,45614,Indfor INCOME INDO REMI19111,,45614,3600,,1507118,.
15643356781,45614,INDO GIBL Indiaforensic STL19111,,45614,613175,,893943,.
15643356782,45614,FDRL/INTERNAL FUND TRANSFE,,45614,,400000,1293943,.
15643356783,45614,FDRL/INTERNAL FUND TRANSFE,,45614,,400000,1693943,.
15643356784,45614,Indfor INCOME INDO REMI20111,,45614,3960,,1689983,.
15643356785,45614,INDO GIBL Indiaforensic STL20111,,45614,628403,,1061580,.
15643356786,45614,Indfor INCOME INDO REMI21111,,45614,1800,,1059780,.
15643356787,45614,INDO GIBL Indiaforensic STL21111,,45614,250951,,808829,.
15643356788,45614,FDRL/INTERNAL FUND TRANSFE,,45614,,300000,1108829,.
15643356789,45614,FDRL/INTERNAL FUND TRANSFE,,45614,,300000,1408829,.
15643356790,45614,FDRL/INTERNAL FUND TRANSFE,,45614,,400000,1808829,.
15643356791,45614,Indfor INCOME INDO REMI25111,,45614,480,,1808349,.
15643356792,45614,INDO GIBL Indiaforensic STL25111,,45614,63600,,1744749,.
15643356793,45614,Indfor INCOME INDO REMI24111,,45614,360,,1744389,.
15643356794,45614,INDO GIBL Indiaforensic STL24111,,45614,49700,,1694689,.
15643356795,45614,Indfor INCOME INDO REMI23111,,45614,1560,,1693129,.
15643356796,45614,INDO GIBL Indiaforensic STL23111,,45614,220402,,1472727,.
15643356797,45614,Indfor INCOME INDO REMI22111,,45614,2280,,1470447,.
15643356798,45614,INDO GIBL Indiaforensic STL22111,,45614,334100,,1136347,.
15643356799,45614,FDRL/INTERNAL FUND TRANSFE,,45614,,400000,1536347,.
15643356800,45614,Indfor INCOME INDO REMI26111,,45614,4440,,1531907,.
15643356801,45614,INDO GIBL Indiaforensic STL26111,,45614,615817,,916090,.
15643356802,45614,FDRL/INTERNAL FUND TRANSFE,,45614,,300000,1216090,.
15643356803,45614,FDRL/INTERNAL FUND TRANSFE,,45614,,400000,1616090,.
15643356804,45614,Indfor INCOME INDO REMI27111,,45614,2760,,1613330,.
15643356805,45614,INDO GIBL Indiaforensic STL27111,,45614,508126,,1105204,.
15643356806,45614,FDRL/INTERNAL FUND TRANSFE,,45614,,400000,1505204,.
15643356807,45614,Indfor INCOME INDO REMI28111,,45614,2160,,1503044,.
15643356808,45614,INDO GIBL Indiaforensic STL28111,,45614,326783,,1176261,.
15643356809,45614,Indfor INCOME INDO REMI29111,,45614,1800,,1174461,.
15643356810,45614,INDO GIBL Indiaforensic STL29111,,45614,247700,,926761,.
15643356811,45614,FDRL/INTERNAL FUND TRANSFE,,45614,,400000,1326761,.
15643356812,45644,Indfor INCOME INDO REMI30111,,45644,3360,,1323401,.
15643356813,45644,INDO GIBL Indiaforensic STL30111,,45644,510703,,812698,.
15643356814,45644,FDRL/INTERNAL FUND TRANSFE,,45644,,400000,1212698,.
15643356815,45644,Indfor INCOME INDO REMI02121,,45644,120,,1212578,.
15643356816,45644,INDO GIBL Indiaforensic STL02121,,45644,5000,,1207578,.
15643356817,45644,Indfor INCOME INDO REMI01121,,45644,840,,1206738,.
15643356818,45644,INDO GIBL Indiaforensic STL01121,,45644,135500,,1071238,.
15643356819,45644,FDRL/INTERNAL FUND TRANSFE,,45644,,500000,1571238,.
15643356820,45644,Indfor INCOME INDO REMI03121,,45644,1560,,1569678,.
15643356821,45644,INDO GIBL Indiaforensic STL03121,,45644,244750,,1324928,.
15643356822,45644,Indfor INCOME INDO REMI04121,,45644,1920,,1323008,.
15643356823,45644,INDO GIBL Indiaforensic STL04121,,45644,233851,,1089157,.
15643356824,45644,FDRL/INTERNAL FUND TRANSFE,,45644,,500000,1589157,.
15643356825,45644,Indfor INCOME INDO REMI05121,,45644,2760,,1586397,.
15643356826,45644,INDO GIBL Indiaforensic STL05121,,45644,437150,,1149247,.
15643356827,45644,Indfor INCOME INDO REMI06121,,45644,2640,,1146607,.
15643356828,45644,INDO GIBL Indiaforensic STL06121,,45644,397925,,748682,.
15643356829,45644,FDRL/INTERNAL FUND TRANSFE,,45644,,500000,1248682,.
15643356830,45644,FDRL/INTERNAL FUND TRANSFE,,45644,,500000,1748682,.
15643356831,45644,Indfor INCOME INDO REMI07121,,45644,1680,,1747002,.
15643356832,45644,INDO GIBL Indiaforensic STL07121,,45644,228177,,1518825,.
15643356833,45644,Indfor INCOME INDO REMI08121,,45644,2160,,1516665,.
15643356834,45644,INDO GIBL Indiaforensic STL08121,,45644,240752,,1275913,.
15643356835,45644,Indfor INCOME INDO REMI09121,,45644,360,,1275553,.
15643356836,45644,INDO GIBL Indiaforensic STL09121,,45644,48000,,1227553,.
15643356837,45644,FDRL/INTERNAL FUND TRANSFE,,45644,,500000,1727553,.
15643356838,45644,Indfor INCOME INDO REMI10121,,45644,4560,,1722993,.
15643356839,45644,INDO GIBL Indiaforensic STL10121,,45644,776851,,946142,.
15643356840,45644,FDRL/INTERNAL FUND TRANSFE,,45644,,500000,1446142,.
15643356841,45644,Indfor INCOME INDO REMI11121,,45644,3360,,1442782,.
15643356842,45644,INDO GIBL Indiaforensic STL11121,,45644,358750,,1084032,.
15643356843,45644,FDRL/INTERNAL FUND TRANSFE,,45644,,500000,1584032,.
15643356844,45644,Indfor INCOME INDO REMI12121,,45644,3360,,1580672,.
15643356845,45644,INDO GIBL Indiaforensic STL12121,,45644,596375,,984297,.
15643356846,45644,FDRL/INTERNAL FUND TRANSFE,,45644,,500000,1484297,.
15643356847,45644,Indfor INCOME INDO REMI13121,,45644,2880,,1481417,.
15643356848,45644,INDO GIBL Indiaforensic STL13121,,45644,419450,,1061967,.
15643356849,45644,FDRL/INTERNAL FUND TRANSFE,,45644,,500000,1561967,.
15643356850,45644,Indfor INCOME INDO REMI14121,,45644,2400,,1559567,.
15643356851,45644,INDO GIBL Indiaforensic STL14121,,45644,423385,,1136182,.
15643356852,45644,FDRL/INTERNAL FUND TRANSFE,,45644,,400000,1536182,.
15643356853,45644,FDRL/INTERNAL FUND TRANSFE,,45644,,400000,1936182,.
15643356854,45644,Indfor INCOME INDO REMI16121,,45644,360,,1935822,.
15643356855,45644,INDO GIBL Indiaforensic STL16121,,45644,33549,,1902273,.
15643356856,45644,Indfor INCOME INDO REMI15121,,45644,1680,,1900593,.
15643356857,45644,INDO GIBL Indiaforensic STL15121,,45644,288851,,1611742,.
15643356858,45644,Indfor INCOME INDO REMI17121,,45644,4440,,1607302,.
15643356859,45644,INDO GIBL Indiaforensic STL17121,,45644,662777,,944525,.
15643356860,45644,FDRL/INTERNAL FUND TRANSFE,,45644,,500000,1444525,.
15643356861,45644,Indfor INCOME INDO REMI18121,,45644,3480,,1441045,.
15643356862,45644,INDO GIBL Indiaforensic STL18121,,45644,616950,,824095,.
15643356863,45644,FDRL/INTERNAL FUND TRANSFE,,45644,,400000,1224095,.
15643356864,45644,Indfor INCOME INDO REMI19121,,45644,3120,,1220975,.
15643356865,45644,INDO GIBL Indiaforensic STL19121,,45644,428150,,792825,.
15643356866,45644,FDRL/INTERNAL FUND TRANSFE,,45644,,500000,1292825,.
15643356867,45644,Indfor INCOME INDO REMI20121,,45644,2640,,1290185,.
15643356868,45644,INDO GIBL Indiaforensic STL20121,,45644,425752,,864433,.
15643356869,45644,FDRL/INTERNAL FUND TRANSFE,,45644,,500000,1364433,.
15643356870,45644,Indfor INCOME INDO REMI23121,,45644,120,,1364313,.
15643356871,45644,INDO GIBL Indiaforensic STL23121,,45644,20000,,1344313,.
15643356872,45644,Indfor INCOME INDO REMI22121,,45644,960,,1343353,.
15643356873,45644,INDO GIBL Indiaforensic STL22121,,45644,130600,,1212753,.
15643356874,45644,Indfor INCOME INDO REMI21121,,45644,2760,,1209993,.
15643356875,45644,INDO GIBL Indiaforensic STL21121,,45644,422577,,787416,.
15643356876,45644,FDRL/INTERNAL FUND TRANSFE,,45644,,500000,1287416,.
15643356877,45644,FDRL/INTERNAL FUND TRANSFE,,45644,,400000,1687416,.
15643356878,45644,Indfor INCOME INDO REMI25121,,45644,1320,,1686096,.
15643356879,45644,INDO GIBL Indiaforensic STL25121,,45644,173441,,1512655,.
15643356880,45644,Indfor INCOME INDO REMI24121,,45644,4680,,1507975,.
15643356881,45644,INDO GIBL Indiaforensic STL24121,,45644,692917,,815058,.
15643356882,45644,FDRL/INTERNAL FUND TRANSFE,,45644,,500000,1315058,.
15643356883,45644,Indfor INCOME INDO REMI26121,,45644,1320,,1313738,.
15643356884,45644,INDO GIBL Indiaforensic STL26121,,45644,250849,,1062889,.
15643356885,45644,FDRL/INTERNAL FUND TRANSFE,,45644,,500000,1562889,.
15643356886,45644,Indfor INCOME INDO REMI27121,,45644,4080,,1558809,.
15643356887,45644,INDO GIBL Indiaforensic STL27121,,45644,625478,,933331,.
15643356888,45644,FDRL/INTERNAL FUND TRANSFE,,45644,,400000,1333331,.
15643356889,45644,Indfor INCOME INDO REMI28121,,45644,1320,,1332011,.
23468456347,45644,INDO GIBL Indiaforensic STL28121,,45644,153500,,1178511,.
23468456348,45644,FDRL/INTERNAL FUND TRANSFE,,45644,,400000,1578511,.
23468456349,45644,Indfor INCOME INDO REMI30121,,45644,240,,1578271,.
23468456350,45644,INDO GIBL Indiaforensic STL30121,,45644,68700,,1509571,.
23468456351,45644,Indfor INCOME INDO REMI29121,,45644,1200,,1508371,.
23468456352,45644,INDO GIBL Indiaforensic STL29121,,45644,200550,,1307821,.
23468456353,45644,FDRL/INTERNAL FUND TRANSFE,,45644,,400000,1707821,.
23468456354,45310,Indfor INCOME INDO REMI31121,,45310,4560,,1703261,.
